31 31
0 1
30 29
* *****************************
*             *       *       *
* ******* ***** * *** ******* *
* * *     *     *   *       * *
* * * ***** ******* ******* * *
* * *       *     *     * *   *
* * ******* * *** ***** * *** *
*   *     *   *       * *     *
*** * *** * ********* * * *****
*   * * * * *   * *   * * *   *
* *** * * *** * * * *** *** * *
* * * *     * * * * * * *   * *
* * * ***** * * * * * * * *** *
*   *   * * * * *     *   *   *
*** *** * * * * *********** * *
*     * * *   * *     *     * *
* ***** * ***** * *** * ***** *
* *     *     * * * *   * *   *
*** ***** *** * * * ***** * ***
*   *   * * *   * *     * *   *
* ***** * * ***** * *** * *** *
*     * * * *     * *     *   *
* *** * * * * * *** ******* ***
* *   * * *   * *   *   *   * *
*** *** * ***** * *** * * *** *
*   *   *       *     * *   * *
* *** *********** ***** *** * *
* *   *       *   *   *   * * *
*** *** ***** * *** * *** * * *
*           *       *   *     *
***************************** *

