6 6
0 1
5 4
* ****
* ****
* ****
*  ***
** ***
**** *
