21 21
0 1
20 19
* *******************
* *         *       *
* * ******* ***** * *
*   *     *     * * *
* *** *** ***** * * *
* *   *     *   * * *
* * *** *** * *** ***
* * * *   * * * *   *
* * * *** * * * * * *
* *   *   * *   * * *
* *** * *** ******* *
*   * * *         * *
*** *** ********* * *
* *   * *   *   * * *
* *** * * * * * * * *
*   * *   * * * *   *
* *** ***** *** *** *
*     *   *   *     *
* ***** * *** * *****
*       *     *     *
******************* *

