5 8
0 1
5 7
* ******
*      *
********
*      *
****** *
