41 41
0 1
40 39
* ***************************************
*       *               *   *       *   *
* * *** ***** ********* * * *** *** * * *
* *   *     *         *   *     *   * * *
***** ***** ***** *** * ********* *** ***
*     *     *   *   * * *     *   *     *
* ***** ***** * ***** *** *** * ******* *
*   *         *       *   *   * *       *
* * ******************* *** *** * ***** *
* * *       *       *   * *   *   *   * *
* * * ***** * ***** * *** *** ******* * *
* * *   *   *   *   *   *   *       *   *
*** *** * * *** * ***** *** ******* *** *
*   *   * * *   *     *           *   * *
* *** *** * * ******* *********** *** ***
* *   *   * * *   * *   *     * *   *   *
* * *** ***** * * * * *** * * * *** *** *
* * * *     *   * * *     * *   * *   * *
* * * ***** ***** * ******* *** * *** * *
* * *     *     *   *     * *     *   * *
* * ***** * *** *** * * * * ******* *** *
* * *   * * *   * * * * * * *         * *
* * * * * * *** * * *** * * * ********* *
* * * * * *   *   *   * * *   *     *   *
* * * * * *** ******* * * ***** *********
*   * *   * *         * * * *           *
* *** *** * *********** * * * ***** *****
* *     * *     *       * *   *     *   *
* ***** * * * *** ***** * ***** ***** * *
*   *   *   * *   *     *     * *   * * *
*** * ********* *** ********* * * * * * *
* * *           * *       *     * *   * *
* * ********* *** ******* ***** * ***** *
*   *       * *         *     * * *   * *
* *** ***** * ******* ******* *** * * * *
*     *     *         *     *       * * *
******* *************** *** *** ******* *
*     *             *   * *   *   *   * *
* * *************** * *** *** ***** * * *
* *                   *             *   *
*************************************** *

