9 11
0 1
8 9
* *********
*     *   *
*** * *** *
*   *   * *
******* * *
*     *   *
* ******* *
*         *
********* *

