5 8
0 1
4 6
* ******
*      *
* ******
*      *
****** *
